WWWW   
Wd WWWW
Wdb   W
Wyb b W
WWWd  W
  WWWWW